ZODIAC 3

PSEUDO : ROADWARRIOR (R.W)

CREW : ZODIAC (NEW !)

REAL NAME : RAFFAEL OTTO ADWARRIOR, WHAT DID YA' THINK ?
                      (HOPE YOU UNDERSTAND THIS SILLY JOKE ...)
                            
SEX : MALE (WOT ELSE ??)

AGE : 17

STATUS IN GROUP : ORGANISATOR, LOGOS

LAND : ITALO-GERMAN (BUT MORE GERMAN)

HAIRSTYLE : LONG BROWN CHAOS

HEIGHT : 177 CM

WEIGHT :       (BETTER NOT)

HABITS : BANG WITH ANY RUNNING WILD SONG ...
         MAKING FEAR TO SUCKERS (E.G. SHOUT LIKE A BERZERK ...)

LOOKS : LIKE A MONSTER AND VEEERY SLEEPY 

CLOTHES : BLACK, BOMBERJACK, SCARF

NORMAL STATE : OUT WITH MY GIRLFRIEND

OTHER HOBBIES : JUDITH, JUDITH, JUDITH, ANY ROLEPLAYGAMES (REAL BOARDS !),
                DRINKING (TOO MUCH), READING D.ADAMS AND T.PRATCHETT

FAVE SAYING : AAAAAAAAAAAAAAAAAAAAAAAAAAAAAAAAAAAAAAAAAAAAAAAAAAAAAAA !
     SCHEISSE (SHIT), DRECKSCHEISS (DIRTY SHIT), OBERSCHEISSE (BIG SHIT !)
          SICHERLICH ! (IF I SOMEONE LIES I ALWAYS SAY 'SURE' ETC.)
          DU HASCH JA SO RECHT ... (SAME AS ABOVE),WIXERDEPP (!)

FAVE BOOKS : ANYTHING FROM DOUGLAS ADAMS AND TERRY PRATCHETT
             (T.P.'S BOOKS ARE AS GOOD AS DOUGLAS'S !)
             CONAN 1-34 EXCEPT 27,LOISE COOPER,DUNE (ALL),
             JAMES BLISH : ENTERPRISE .... (=STAR TREK)

WORST BOOKS : MATHEMATIK INFINITISSIMALRECHNUNGEN 11.KLASSE (PFUI!)
              OVID,C.J.CAESAR,SALLUSTIUS - ANY LATIN ....

FAVE MUSIC : OH . DIFFICULT . RUNNING WILD,JUDAS PRIEST,ALICE COOPER
             MOTORHEAD,LASERDANCE,KOTO,ANY POPCORN,JARRE,ZZ-TOP,
             OZZY OSBOURNE,RONDO VENEZIANO,WESTBAM (OLD ONES),GURU
             JOSH,ART OF NOISE,ANY DISCOSOUND FROM 1980-1985,ANY
             METAL MUSIC AFTER 1983 . ANY MUSIC ....

FAVE SONG : SEVERAL . FUTURE WORLD FROM PRETTY MAIDS
            CONQUISTADORS BY RUNNING WILD, EAT THE RICH ETC...

FAVE TV-PRG : WANTED (SUPER CHANNEL), AIRPLAY (PREMIERE PAY-TV),
              ANY ALF OR ENTERPRISE, METALMIX (SUPERCHANNEL)

WORST TV-PRG : NEIGHBOURS, PRICE IS HOT, GLUECKSRAD (VOMIT !)

BEST MOVIE : ANY FANTASY FILMS, B.SPENCER&T.HILL-MOVIES, TERMINATOR 1 (!)

WORST MOVIE : NAKED GUN 1 (REALLY !), TERMINATOR 2 (NO TENSION !) 

FAVE COMPUTER : ARHM, AMIGA ?
                         (NO . NO.NO.NO. I MEAN MEGA STE !)

WORST COMPUTER : MY OLD 520 STM (SOMETIMES THERE ARE FLASHING LIGHTS
                 OUT OF THE MAINS CONNECTION ....)

FAVE GAMES : BY FAR LETHAL XCESS (W.O.D. 2) TOGETHER WITH POISON
             THUNDERFORCE 3 AND SONIC THE HEDGEHOG (MEGADRIVE)
             DUNGEON MASTER, WINGS OF DEATH, DUGGER (!)
             REAL-ROLEPLAYGAMES LIKE DSA, AD&D, WARHAMMER AND THORGRIM

WORST GAMES : COMPUTER-ROLEPLAYGAMES (ALL SHIT !!!)
              BEAST 1+2 (WHY THIS GOOD INTRO IN BEAST 2 AND SHIT GAME ?)

FAVE DEMOS : OH,DIFFICULT QUESTION . CRICKEY WOT A SCORCHER,
             EUROPEAN DEMOS, SYNTAX, PUNISH YOUR MACHINE, DARK SIDE ...

WORST DEMOS : FANATICS RECKLESS MEGADEMO

BEST DEMOCREW : DON'T KNOW . MAYBE LOST BOYS. OR OVERLANDERS OR
                CAREBEARS . 

WORST GROUPS : SOOOO MUCH OF THEM .

FAVE VIRUS : FAVE ? FAVE ? AAAAAAAAAAAAAAAAAAAAAAAAAAAAAAAAAAAAARRRRRGGH !

WORST VIRUS : HM . AIDS OR SYPHILIS OR ANYTHING LIKE THAT ...

BEST DISCMAGACINES : DBA, MAGGIE

WORST DISCMAGS : NONE . ALL OF THEM ARE NICE .

FAVE CONSOLE : MEGADRIVE . IF THERE WOULD BE BETTER SPRITE-HARDWARE,
               THE SUPER-NES, BUT SO ... MEGADRIVE + MEGA CD !

WORST CONSOLE : NES,MASTERDRIVE,ANY HANDHELD

BEST NIGHT OUT : MY FIRST NIGHT WITH PETRA BEUTEL (GRINS !)

GIRLFRIEND : JUDITH . A LITTLE BLOND HOT ONE .

FAVE GIRL : JUDITH D.

FAVE FOOD : KARTOFFELPUFFER, WIENER SCHNITZEL MIT HEINZ HOT KETCHUP
            EVERYTHING MADE FROM CHICKEN (e.g.McNUGGETS) 

WORST FOOD : HAMBURGER (WUUEEERG !   (=VOMIT !))

BEST THOUGHT  : STAYING TOGETHER WITH JUDITH 1 YEAR

WORST THOUGHT : STAYING TOGETHER WITH JUDITH 1 YEAR (HA HA HA)
                BEEING FORCED TO WORK ON MS-DOS ...........

