MIKE OF STAX


Interview with Mike of STAX, so get reading,

NAME:    MICHAEL   - THE REST IS MY SECRET ...
PSEUDONYM:    MIKE  ( VERY ORIGINAL , EH ?? )
CREW:    STAX ( OF COURSE ! )
STATUS IN CREW:    A LITTLE BIT CODING , GRAFIX ...
SEX:    WHY NOT ???
AGE:    SWEET 19
HEIGHT:    1.87 METER ( AT LEAST ! ) 
HAIR:    BROWN WITH LITTLE BLONDE BITS
LOOKS:    DECIDE FOR YOURSELVES
FAVE JOKE:    "PLEASE SAY SOMETHING INTELLIGENT !" 
            - " HHMM ... BAAUUMM . " ( AN ANTI JOKE ... )
FAVE SAYING:    ALL OR NOTHING 
FAVE COLOR:    PERHAPS RED ... BUT I MUST ADMIT I LOVE THEM ALL ... 
FAVE GIRL:          THE DREAMS AREN'T FULLFILLED YET ... 
HOBBIES:    COMPUTER , FOOTBALL ( THE GERMAN VERSION OF IT ! )
            PARTIES AND TELEPHONING ...
FAVE FOOD:    - SOMETHING HEARD FROM THAT FAMOUS " BIG MAC " ?
              - PIZZA 
FAVE DRINK:    HEFE-WEISSBIER (FOR THE ENGLISH PEOPLE : BEER,BEER ...)
MUSIC TASTE:    DEPECHE MODE , SISTERS OF MERCY , BILLY IDOL , ERASURE
                BELINDA CARLISLE ( A SOFTY YOU WILL THINK ... ) BUT ALSO
                THINGS LIKE JAN HAMMER , TANGERINE DREAMS OR KRAFTWERK !
FAVE FILMS:    TERMINATOR II , TERMINATOR , TOTAL RECALL , TOP GUN
               SNAPSHOT , STAR WARS I-III , ALIENS I+II (MY ALL TIME 
               FAVOURITE ! ) ...
WORST FILMS:    THERE WOULD BE TOO MANY TO MENTION ... 
BEST NIGHT OUT:    SILVESTER PARTY 90/91
BEST GAME:    SPEEDBALL,XENON II , DUNGEON MASTER , TAURIS
              NOT TO MENTION CLASSICS LIKE METROCROSS,GAUNTLET II  ..
WORST GAME:    SOME FUCKING SOCCER GAMES ( DON'T REMBEMBER THE NAMES ) 
BEST DEMOCREW:    THE CAREBEARS  
BEST DEMO:    THE UNION DEMO 
              BUT I LIKE OTHERS TOO LIKE THE ULM - DARK SIDE ...
FAVE COMPUTER:    MY OLD ATARI ST 
FAVE VIRUS:    THE ONE WHICH FILLS THE SCREEN PLAYING TAURIS FOR OVER
               2 HOURS ...
WORST DEMOCREW:    EVERYONE HAS ONCE A BAD DAY ...
WORST DEMO:    I FORMAT THE BAD ONES AT ONCE SO I DON'T REMEBER THE NAMES
FAVE SERIE ON TV:   "DAS MODEL UND DER SCHNUEFFLER"
WORST SERIE ON TV:  THE REST ...
BEST THOUGHT:    THINKING ABOUT THIS SUMMER ....
WORST THOUGHT:    THINKING ABOUT 1.10. - I AM IN THE ARMY NOW ...


